##########
#CCCCCCCC#
#MCCCCCCC#
#SSSSSSCC#
#CCCCSCCC#
#SCCCCCCC#
#CCCCCCCC#
#CCCCCCCC#
#PCCCCCCM#
##########